allè|alle
allèen|alleen
bakken
bukt
byen
dalen
flate
gata|g|gt
gate|g|gt
gaten
lia
park
plass|plassen|pl
stortorget
stredet
svingen
veg|vegen|v|vn
vei|veien|v|vn
haugen
skogen|skog
gården|gård
åsen
gård|gården
holm|holmen
haugen|Haugane
krysset
skogen|skog
grend|grenda
flat|flaten
våg|vågen
strand|stranda|stranden
vik|vika
platå
stad
terrasse
hage|hagen|hager
øya
lund|lunden
holm|holmen
berg|berget
landa|lande|landet
dal|dalen
sund
bakke|bakken
høgda|høgde
borg|borgen
gard|garden|garda
mark|marka
voll|vollen
sjø|sjøen
lie
sti|stien
tangen